ali -> ambi
karim -> karkar
hana -> honête
souhé -> spont
yondes -> yeser_7aja
iheb -> intellig
sirine -> souriante
ghofran -> gentille
mouna -> modeste
farah -> farfecha
mehdi -> malin
safa -> so_cute
slim -> serieux
mohamed_ali -> minutieux
youssef -> yeser_7aja
amna -> actif
sarra -> serieuse
amir -> adorable
feriel -> funny
Eslem -> elegante
ghada -> gentille
khouloud -> kind
rania -> ravissante
azza -> adorable
khaoula -> kind
rihem -> respectueuse
mouna -> motivé
afrah -> aimable
aya -> ambitieuse
nadia -> nostalgique
  
